1111111111111
1C01P0000C0C1
110C111110001
10C0000C00001
1111110000001
10010100001C1
1111111111111
